amd - Армянский драм
aud - Австралийский доллар
azn - Азербайджанский манат
bgn - Болгарский лев
brl - Бразильский реал
byn - Белорусский рубль
cad - Канадский доллар
chf - Швейцарский франк
cny - Китайский юань
czk - Чешских крон
dkk - Датских крон
eur - Евро
gbr - Фунт стерлингов
huf - Венгерский форинт
inr - Индийских рупий
jpy - Японских иен
kgs - Киргизский сом
krw - Вон Республики Корея
kzt - Казахских тенге
mdl - Молдавский лей
nok - Норвежских крон
pln - Польский злотый
ron - Новый румынский лей
sek - Шведских крон
sgd - Сингапурский доллар
tjs - Таджикский сомон
tmt - Новый туркменский манат
try - Турецкая лира
uah - Украинский гривен
usd - Доллар США
uzs - Узбекский сум
xdr - СДР (специальные права заимствования)
zar - Южноафриканский рэнд
